Outer Darkness
-----------------
-HHHXHHRHRHXHH+H-
-H+HHHHXHHH+HHHH-
-XHHDHHHHIHHXXHH-
-HHH%HXHHHXHKHHH-
-HKHHHXHXHHHRHHH-
-HHRHH+HHHKHHXHH-
-HHXHHHHHXHHRHHH-
-HHHHHHHHHH+HRHH-
-H+HRHHXH+HRHHHH-
-HHHHRHRHRH+HHHH-
-----------------