Movement and Gold
-----------------
-        +      -
-H H R H+K H K K-
- H%H+H H R H  I-
-H D H R H H H H-
-     +    +    -
-----------------