Rocks Hurt
-----------------
-+           +  -
-X +  XX+ X     -
-HDH% HR  H  X I-
-----------------