Coffee, Black
-----------------
-HH+XHKHHXHHHRHH-
-HRHK+HHRH H+HHH-
-XHHDH+HK IHXXHH-
-HHH%RHHH+XHHRHH-
-+HHHRHHKHHHH+HH-
-----------------